25 15
1 1 1 1 1 1 1 1 1 1 1 1 1 1 1 1 1 1 1 1 1 1 1 1 1 
1 0 0 0 0 0 0 0 0 0 0 0 0 0 0 0 0 0 0 0 0 0 0 0 1 
1 0 0 0 0 0 0 0 0 0 0 0 0 0 0 0 0 0 0 0 0 0 0 0 1 
1 0 0 0 0 0 0 0 0 1 0 0 1 0 0 0 0 0 0 0 0 0 0 0 1 
1 0 0 0 0 0 0 1 0 0 0 5 0 0 1 0 0 0 0 0 0 0 0 0 1 
1 0 0 0 0 1 0 0 0 4 0 0 0 0 0 1 0 0 0 0 0 0 0 0 1 
1 0 0 0 1 0 0 0 0 0 4 0 0 0 0 0 1 0 0 0 0 0 0 0 1 
1 4 4 1 0 0 0 0 0 4 3 4 0 0 0 0 0 1 0 0 0 0 0 0 1 
1 4 0 0 1 0 0 0 4 3 3 3 4 0 0 0 0 1 0 0 0 0 0 0 1 
1 0 0 4 0 1 0 0 0 4 3 4 0 0 0 0 0 1 0 0 0 0 0 0 1 
1 0 0 0 0 0 1 0 0 0 4 0 0 0 0 0 1 0 0 0 0 0 0 0 1 
1 0 0 0 0 0 0 1 0 0 0 0 0 0 0 1 0 0 0 0 0 0 0 0 1 
1 0 4 3 0 0 0 0 1 0 0 0 0 0 1 0 0 0 0 0 0 0 0 0 1 
1 3 2 4 0 0 0 0 0 4 1 0 1 0 0 0 0 0 0 0 0 0 0 0 1 
1 1 1 1 1 1 1 1 1 1 1 1 1 1 1 1 1 1 1 1 1 1 1 1 1 
