15 20
1 1 1 1 1 1 1 1 1 1 1 1 1 1 1 
1 0 0 0 0 0 0 4 2 0 1 0 0 0 1 
1 0 0 0 0 3 3 1 4 4 1 0 0 0 1 
1 0 0 0 3 3 3 1 4 4 1 3 3 0 1 
1 0 0 3 3 3 3 1 4 4 1 3 3 0 1 
1 4 1 1 1 1 1 1 4 4 1 1 1 4 1 
1 0 0 0 0 0 0 4 0 0 4 0 0 0 1 
1 0 1 1 1 1 1 1 0 0 1 1 1 4 1 
1 0 1 3 3 3 3 1 0 0 1 3 3 3 1 
1 0 1 3 3 3 3 1 0 0 1 3 3 3 1 
1 0 4 3 3 3 3 1 0 0 1 0 0 0 1 
1 0 1 1 1 1 1 1 0 0 1 1 4 4 1 
1 0 1 3 3 3 3 1 0 0 1 3 3 3 1 
1 0 4 0 3 3 3 1 0 0 1 3 3 3 1 
1 1 1 1 1 1 1 1 1 0 1 1 1 1 1 
1 0 0 0 5 1 1 0 0 0 0 1 1 1 1 
1 0 0 1 1 1 0 4 0 0 0 0 1 1 1 
1 0 0 0 0 0 0 0 0 0 0 0 0 1 1 
1 0 0 4 0 0 0 0 0 4 0 0 0 0 1 
1 1 1 1 1 1 1 1 1 1 1 1 1 1 1 
