15 15
1 1 1 1 1 1 1 1 1 1 1 1 1 1 1 
1 0 0 0 0 0 0 0 0 0 0 0 0 0 1 
1 0 0 0 0 1 1 1 1 1 5 0 0 0 1 
1 0 0 0 0 0 1 0 1 0 0 0 0 0 1 
1 0 0 0 0 1 0 3 0 1 0 0 0 0 1 
1 0 0 0 0 0 0 4 0 0 0 0 0 0 1 
1 0 0 0 0 1 1 1 1 1 0 0 0 0 1 
1 0 0 0 0 1 3 1 3 1 0 0 0 0 1 
1 0 0 0 0 1 0 1 0 1 0 0 0 0 1 
1 0 0 0 0 0 4 0 4 0 0 0 0 0 1 
1 0 0 0 0 1 1 1 1 1 0 0 0 0 1 
1 0 0 0 0 0 1 2 1 0 0 0 0 0 1 
1 0 0 0 0 1 0 4 0 1 0 0 0 0 1 
1 0 0 0 0 0 0 0 0 0 0 0 0 0 1 
1 1 1 1 1 1 1 1 1 1 1 1 1 1 1 
