10 5
1 1 1 1 1 1 1 1 1 1 
1 3 3 3 4 0 4 4 3 1 
1 4 4 4 0 0 1 0 3 1 
1 5 0 0 0 0 1 0 2 1 
1 1 1 1 1 1 1 1 1 1 
