20 15
1 1 1 1 1 1 1 1 1 1 1 1 1 1 1 1 1 1 1 1 
1 0 0 0 0 4 4 0 0 0 0 0 0 0 0 0 0 0 0 1 
1 0 1 1 1 1 1 1 1 1 0 0 0 4 0 0 0 0 3 1 
1 5 0 0 0 0 0 0 1 0 0 0 0 0 0 3 0 0 0 1 
1 0 0 0 0 4 0 1 0 0 0 0 0 0 0 0 0 0 0 1 
1 0 0 0 0 0 1 0 0 0 0 4 0 0 0 0 0 0 0 1 
1 0 0 0 0 1 0 0 0 0 0 0 0 0 3 0 0 0 0 1 
1 0 0 0 1 0 0 0 0 0 0 0 0 0 0 0 0 0 0 1 
1 0 0 1 1 1 1 1 1 1 0 0 0 0 0 0 0 0 0 1 
1 0 0 0 0 0 0 0 0 0 0 4 0 0 0 0 0 0 0 1 
1 0 0 0 0 0 4 0 0 1 1 1 1 0 0 0 0 0 0 1 
1 0 0 0 0 0 0 0 0 0 0 1 0 0 0 4 0 0 4 1 
1 0 0 0 4 0 0 0 0 0 1 0 0 0 4 3 4 3 0 1 
1 0 0 0 0 0 0 0 0 1 1 1 1 0 0 4 3 2 3 1 
1 1 1 1 1 1 1 1 1 1 1 1 1 1 1 1 1 1 1 1 
